1111111111111111111111111111111111111111111111111111111111111111111111
1000000000000000000000000000000000000000000110000000000000000000000001
1000000000000000000000000000000000000000000110000000000000000000000001
1000000000000000000000000000000000000000000110000000000000000000000001
1000000000000000000111111111111111110000000110000000000000000000000001
1000000000000000000000000001100000000000000110000000000000000000000001
1000000000000000000000000001100000000000000110000000000000000000000001
1000000000000001111111111111111111111111100110000000000000000000000001
1000000000000000000000000111000000000000000110000000000000000000000001
1000000000000000000000001101100000000000000111100000000000000000000001
1000000000000000000000011000111000000000000000011110000000000000000001
1000000000000000000001100000000111000000000000000011110000000000000001
1000000000000000000111000000000001110000000000000001111111111111100011
1000000000000000011100000000000000011110000000000000000000000000001111
1000000000011111110000000000000000001111110000000000000000000000111111
1000000000000000000000000000000000000000000000000000000000000011111111
1000000000000000000000000000000000000000000000000000000000000000011111
1000000000000000000000000000000000000000000110001100011110011000001111
1000000000000000000000000000000000000000000000000000000000000000000111
1000000000000000000000000000001111111111111000000000000000000000000011
1000000000000000000000000000111000000000011110010000000000000000000001
1000000000001110000000000011110000000000000000011100000000000000000001
1000000000100000010000001111100000000000000011111110000000000000000001
1110000100000000000001111111100000000000000011111111100000000000000001
1111100000000000000111111111100000000000001111111111000000000000000001
1111111100000000000000000000101111111111111100000000000000000000000001
1111111111111000111100000000000000000000000000000011111111111000000001
1000000000000000000000000000000000000111111110000000000000000000000001
1000000000000000000000000000000000001100000000000000000000000000000001
1000000000000000000000000000000000011000000011111111111000000000000001
1111111111111111111111111001111111110000000000000000011111111111000001
1000000000000000000000000000000000000000000000000000011000000000000001
1000000000000000000000000011111111111111111110000000011000000000000001
1000000000000000000000000000000000000000000111111111111000000111111111
1000000000000000001111111000000000000000000000000000000000000000000001
1111111111111111111100001100000000000000000000000000000000000000000001
1000000000000000000000001111100000000000000000011111111111111111111111
1000000000000000000000000001100000000000000000000000000000000000000001
1000000000000000000000000000000000000000000000000000000000000000000001
1111111111111111111111111111111111111111111111111111111111111111111111